11111111111111111111111
1P000C000000000C0000001
10111111110111111111101
1000C0000000000000C0001
10111011111111101110101
1C000000000C000000000E1
10111111111011111111101
10000C00000000C000000C1
10111011111111101110101
1C00000000C00000000C001
10111111110111111111101
1000C0000000000000C0001
10101110111111011101101
1C000000C00000C00000001
11111111111111111111111
