1111111111111
10010000P0001
1000011111CC1
100011E000101
1111111111111
