11111111111111111111111
1P0M0C00000M000C0000001
10111111110111111111101
1000C0000000000000C0001
10111011111111101110101
1C000000000C00000000E01
10111111111011111111101
10000000000000000M00011
10111111110111111111101
1000C0000000000001C1001
10101110111111011101101
1C000000C00000C00000001
11111111111111111111111
